abonamęt  - abonament
agrawce - agrafce
akcesorii - akcesoriów
akfamaryną - z akwamarynem
aktułalnie - aktualnie
akwariumowy - akwarystyczny
allegrowiczą - allegrowiczom
allegrowiczy - allegrowiczów
altomatow - automatów
ałkcja - aukcja
ałkcjie - aukcję
ampółkę - ampułkę
angarzuje - angażuje
antyrozpryzkową - antyrozpryskową
aódi - audi
apsolutnie - absolutnie
apsurd - absurd
arafadki - arafatki
Arde Co - patrz: ardeko
ardeko - Art Deco
aromaterapełtyczne - aromaterapeutyczne
artykół - artykuł
atmoswera - atmosfera
atramęcie - atramencie
aukcie - tę aukcję, inne aukcje
aukcjia - aukcja
awiędz - a więc
bać - bądź
bagarznik - bagażnik
balejarzem - balejażem
bąbki  - bombki
beasbolóka - bejsbolówka, fason kurtki
beczółka - beczułka
Beder Majer - biedermeier
bende - będę
bendzie - będzie
berzowy - beżowy
bescen - bezcen
beszczelny - bezczelny
bencwale - bęcwale
bezceler - bestseller
bezcent - bezcen
będoł - będą
bęty - bełty
bęzynowa - benzynowa
bierzący - bieżący
bimboniera - bomboniera
biórko - biurko
biuzcie - biuście
blad - blat
blądyna - blondyna
blew - blef
bluska - bluzka
bodajrze - bodajże
bolcy - bolców
bombelkowa koperta - bezpieczna koperta z folią bąbelkową
bonos - bonus
bódzik - budzik
branzoleta  - patrz: brązoletka
brązoletka - bransoleta
brobinkami - drobinkami
bronsoletę - bransoletę
bronzowy - brązowy
brożka - broszka
bródny - brudny
brudna róż - brudny róż
brylok  - brelok
bulem - bólem
bydlencej - bydlęcej
cantry - country
cfaniak - cwaniak
cieszki - ciężki
cieszki urzytkownik do tranzakcji - patrz: cieszki, tranzakcja, urzytkownik
cież - ciesz 
ciękie - cienkie
chaftki - patrz: hawtki
chalasuje - hałasuje
chalka - halka
chalogenowa - halogenowa
chamulec  - hamulec
chandlować - handlować
chawt - haft
chcem - chcę
cheblowania - heblowania
chełmo-kask - hełmo-kask
cherb - herb
cherbacianego - herbacianego
chisteryczna - histeryczna
chity - hity
chiszpańskim - hiszpańskim
chlajnoga - hulajnoga
chlopakowe - chłopięce
chociarz - patrz: chociasz
chociasz - chociaż
chodowany - hodowany
chomologacja - homologacja
chonorowe - honorowe
chorednalnie - horrendalnie
chospitalizacja - hospitalizacja
chumor - humor
churtowa - hurtowa
 cieczom - cieczą
ciencia - cięcia
cienżarowy - ciężarowy
cięką - cienką
ciongnik - ciągnik
cipelutki/a - cieplutki/a 
cód - patrz: cut
códowna - cudowna
curka - córka
cut - cud
cuż - cóż
cyfronicznego - cyfrowego
czciny - trzciny
czeba - trzeba
czegusz - czegóż
czeńści - części
czeszczy - trzeszczy
czonku - trzonku
czójnik - czujnik
czułenka - czółenka
czyma - trzyma
czyszczęce - czyszczące
czytać umię - czytać umiem 
daleko sienrzne - dalekosiężne
darójmy - darujmy
delikfent - delikwent
dekold  - dekolt
dekoldzik  - patrz: dekolcik
dekolcik - idiotyczne zdrobnienie
dembowy - dębowy
dewiską - dewizką
dłóg - dług
dłógość - długość
długowietrzna - długowieczna
dobur - dobór
dokujoncom - dokującą
dokumęty  - dokumenty
dolanczam  - dołączam
dopuki - dopóki
dorobinami - drobinami
dotąt - dotąd
dożucam  - dorzucam
dożucić - dorzucić
dópa - dupa
drahm - drachm
drapierzne - drapieżne
drógim - drugim
drzemy - dżemy
dugopis - długopis
dul - dół
durzej - dużej
durzej - dłużej
durzo - dużo
dwónastka - dwunastka
dwóstronna - dwustronna
dziecience - dziecięce
dzienkuje  - dziękuję
dzież - dzieża
dzióra - dziura
dzwienku - dźwięku
dżazg - drzazg
dźwi - drzwi
ecrue  - patrz: écru
ecrui  - patrz: écru
ecry  - patrz: écru
ecure - patrz: écru
efektowane - efektowne
egzemplaż  - egzemplarz
egzęplarz  - patrz: egzemplaż
egzęplaż  - patrz: egzęplarz
ekri  - patrz: écru
ekrii - patrz: écru
ekru - patrz: écru 
ekry - patrz: écru
eksklózywne - ekskluzywne
elegandzka - elegancka
energi - energii
eqri - patrz: écru
eqrie - patrz: écru
eqru - patrz: écru
essei - esejów
etłi - etui
exstra - ekstra, extra
extrymalnie - ekstremalnie
faktórą - fakturą
feair - patrz: fer
fer - patrz: ferr
ferplej - fairplay
ferr - fair
figorka - figurka
figóry - figury
filcharmonia - fisharmonia
firzbiny - fiszbiny
fizalnie - finalno-wizualnie?! ;-/
fiżbinie - fiszbinie
fjoletowego - fioletowego
fluorostencyjne - fluorescencyjne
flustracje - frustracje
francuzki  - francuski
francuzki - Francuzki
frendzle  - frędzle
fri - free
fszystkie - wszystkie
ftedy - wtedy
full wypas  - z maksymalnym możliwym wyposażeniem
funkiel  - błyszczący nowością, "jak spod igły"
garasz - garaż
garczków - garnczków
gąg - gong
gąpeczki - gąbeczki
geodeta - w znaczeniu: geoda
giątki - giętki
gipiórową - gipiurową
głatko lufowa - gładkolufowa
gmatfanina - gmatwanina
gniecący - gniotący
gobka - gąbka
golembi - gołębi
gokard - gokart
gombka - patrz: gompka
gompka - gąbka
gómce - gumce
góru - guru
góże - górze
grabaża - grabarza
gradka  - gratka 
groby - gruby
gróbą - grubą
gródnia - grudnia
gudyar - goodyear
gwarka - gwarancja
gwiastką - gwiazdką
gwizda - gwiżdże
habrowego - chabrowego
ham - cham
hamólcowe - hamulcowe
hamstwo - chamstwo
haotycznuy - chaotyczny
harczą - charczą
hawtem - haftem
hawtki - haftki
hawtowanego - haftowanego
hce - chce
hcesz - chcesz
hętnie - chętnie
Hicago - Chicago
hlam - chłam
hlebak - chlebak
hlubę - chlubę
hoć - choć
hodzą - chodzą
hodzi - chodzi
hohlą - chochlą
holera - cholera
holewki - cholewki
homika - chomika
homonto - chomąto
horobach - chorobach
hromoterapi - chromoterapii
hromowanych - chromowanych
hudą - chudą
huj - chuj
huj ci w dópe - chuj ci w dupę
husta - chusta
hyba - chyba
imicz - image
impreskę - imprezkę
inchalacja - inhalacja
insygnowane - sygnowane
intarsia - intarsja
inteligętni - inteligentni
intensyfności - intensywności
interwęcje - interwencje
ito - i to
jabukowym - jabłkowym
jagby - jakby
jansu - dżinsu
jaszczorki - jaszczurki
jerzeli  - jeżeli
jerzli - jeśli lub jeżeli ;)
jeźorem - jeziorem
jóż  - patrz: jurz
jurz - patrz: jusz
jusz  - już
kakretne - konkretne
kaledaz - kalendarz
kaleusik - kapelusik
kałamasz - kałamarz
kałcje - kaucję
kałczuk - kauczuk
kamuflarzu - kamuflażu
karzdy - każdy
kato - patrz: kąto
katrachent - patrz: kontrachent
kąkretny - konkretny
kąpa - kompa
kąplet - komplet
kątakt - kontakt
kątą - patrz: kąto
kąto - konto
kędzieżawy - kędzierzawy
kiletem - klientem
kjosku - kiosku
klamrom - klamrą
klawiatórce - klawiaturce
klączków - kłaczków
klenkaicje - klękajcie
klijęt, klijęta - klient, klienta
kluczów - kluczy
kłamcom - kłamcą
kłudeczkę - kłódeczkę
koferku - kuferku
koleszka - koleżka 
koloże - kolorze
koładka - kołatka
kołnież  - kołnierz
komentaż - patrz: kometaz
kometaz - patrz: komętarz
komętarz - patrz: komętaż
komętaż - komentarz
komóurka - patrz: komurka
kompiel - kąpiel
kompetecje - kompetencje
komurka  - telefon komórkowy
konflikacje - komplikacje
konkuręcja - konkurencja
konsekwętny - konsekwentny
kontówką - kantówką
kontrachent - kontrahent
konzystencjia - konsystnecja
końciku - kąciku
kończyny - koniczyny
kopóle - kopule
korąki - koronki
korespądencje - korespondencję
korzuszkiem - kożuszkiem
kostjum - kostium
kozystac - korzystać
kórtka  - kurtka
kórz - kurz
kradzierz - kradzież
kretki - kredki
krodko - krótko
kroszki - krążki
królowy - królowej
kruj - krój
krulestwo - królestwo
krutki  - krótki
krztałt - kształt
ksiarzki - książki
kucarzom - kucharzom
kułka - kółka
kupujoncom - kupującą
kuży - kurzy
kwarancyjna - gwarancyjna
kżyżowych - krzyżowych
labolatorium - laboratorium
laeycrą - lycrą
laicra - patrz: laikra
laikra  - patrz: lajkra
lajkra  - patrz: licra
latrelek - ratlerek
lążowania - lonżowania
legęda - legenda
leprzy  - lepszy
lerzy - leży
licra  - patrz: lykra
likfidacji - likwidacji
litycacia - licytacja
londowych - lądowych
ludkowy - łódkowy
ludzią - ludziom
lykra - lycra
łącużku - łańcuszku
łeski - łezki
łgaż - łgarz
łonczące - łączące
łonczony -łączony
łonki - łąki
łudka - łódka
łudkowatym - łódkowatym
łukos - ukos
łużeczko - łóżeczko
łużka - łóżka
machoń - mahoń
madmlazel - mademoiselle
magnetowit - magnetowid
maitasy - majtasy
maitki - majtki
makijarz - makijaż
mankamęty - mankamenty
marichuany - patrz: marychuany
marychuany - marihuany
marynażyk - marynarzyk
maturzysztow - maturzsytów
maż - masz 
mątarzem - montażem
mątarzowe - montażowe
menszczyzny - mężczyzny
mentną - mętną
mereszką - mereżką
mędo - mendo
męszczyzn - mężczyzn
miałczenie - miauczenie
miej więcej - mniej więcej
mieżona - mierzona
miljonerem - milionerem
minoł - minął
miszkasz - mieszkasz
mkiełka - mgiełka
młucenia - młócenia
mnustwo - mnóstwo
modól  - moduł
mojih - moich
momęcik - momencik
mondrala - mądrala
morzna  - można
morzliwość - możliwość
mruz - mróz
mydłów - mydeł
na predce - naprędce
na zajutsz - nazajutrz
nadchnienia - natchnienia
najleprze - najlepsze
nakrędka - nakrędka
napszykład - na przykład
narzędź - narzędzie
nastempnej - następnej
nawieszchni - nawierzchni
nawilrzacz - nawilrzacz
nazady - narządy
nedbuka - notebooka	
nepowtuzy - nie powtórzy
nie rosadny - nierozsądny
niedoś - niedość
niefer - nie fair
nieodzy - nie odzywa
nieporzałujesz - nie pożałujesz
niepowtażalny - niepowtarzalny
nierozrzużnia - nie rozróżnia
nieśmigane - nie używane
nietszeba - nie trzeba
nietylko - nie tylko
niewlancza - nie włącza
niewpozatku - nie w porządku
niezależnom - niezależną
niezruwnowarzony - niezrównoważony
nirzej - niżej
nizkim - niskim
nizkiego - niskiego
noofka - patrz: nufka
nowiudka - nowiutka
noworotka - noworodka
nórka - nurka
nówka - coś nowego
nufka - patrz: nówka
nuszki - nóżki
nuwka - patrz: nufka
objektywy - obiektywy
obnirzaja - obniżają
obopulnie - obopólnie
obódowa - obudowa
obówia - obuwia
obówniczym - obuwniczym
obrubki - obróbki
obrucone - obrócone
obsóguje - obsługuje
obsłózy - obsłuży
obwudka - obwódka
ocielpane - ocieplane
ocierć - otarć
oczymałem - otrzymałem
odbiur  - odbiór
odeprały - sprały
odkrencana - odkręcana
odlanczana - odłączana
odpowieć - odpowiedź
odprówających - odpruwających
odrzywek - odżywek
odtważacz  - odtwarzacz
odważacz - odtwarzacz
odwdzieńczyłem - odwdzięczyłem
ofszem - owszem
oglondany - oglądany
ogresteurowany - odrestaurowany
okrongłe - okrągłe
olifkowy - oliwkowy
oneks - onyks
oprucz  - oprócz
oprzycie - obszycie
opsydianu - obsydianu
opszerz - oprzesz
opszyty - obszyty
opwod - obwód
orginalnoł - oryginalną
orginał - patrz: orgynał
orgynał - oryginał
orjętacyjne - orientacyjne
orzeły - orły
osobą trzecim - osobom trzecim
osobosie - osobiście
oswuj - oswój
oszczale - ostrzale
oszczona - ostrzona
otkurzacz - odkurzacz
otuz - otóż
ozdubki - ozdóbki
oznaków - oznak
ożełek - orzełek
pahnie - pachnie
pamienc  - pamięć
papuszka - papużka
parfum - patrz: perfum
paseczką - paseczkom
pasi - pasuje
pasowne - pasujące
pastwisze - pastisze
pazórki - pazurki
pączu - ponczu
pąpka - pompka
pejzarz  - pejzaż
pełnom - pełną
pempek - pępek
pendzelek - pędzelek
penkaj - pękaj
pentelke - pętelkę
perfum - patrz: perfuma
perfuma  - perfumy
persfazyjna - perswazyjna
pienaszki - pieniążki
pierściąki - pierścionki
piniadze na konot - pieniądze na konto
piuro - pióro
plany ma przegach - plamy na brzegach
pląba - plomba
plutna - płótna
pluz - plus
płuka - płucze
pnęmatyczne - pneumatyczne
poczkującym - początkującym
podczymywacz - podtrzymywacz
podeszfa - podeszwa
podknięcia - potknięcia
podpurka - podpórka
podruży  - podróży
podrzewka - podszewka
podsumowójąc - podsumowując
podstupek - podstópek jesli już...
pogruszkami - pogróżkami
pohodzenia - pochodzenia
pokrentełka - pokrętełka
pokrowiedz - pokrowiec
pocentjometry - potencjometry
pod-pouri - pot-pourri
podpurką - podpórką
polewej - po lewej
pomodz - pomóc
poniewarz  - patrz: poniewasz
poniewasz  - ponieważ
ponirzej - poniżej
ponorzszych skrutów - poniższych skrótów 
popacz - popatrz
poprzes  - poprzez
poraszka - porażka
porawej - po prawej
portponetka - portmonetka
portwel - porfel
porysałem - porysowałem
porzukniete - pożółknięte
posionc - posiąść
poską - paskom
posówa - posuwa
postempowaniem - postepowaniem
posysowane - porysowane
pot - pod 
potecionometry - potencjometry
potrzewka - podszewka
powieczne - powietrzne
powieszchownie - powierzchownie
pozbąć - pozbądź
poziomnice - poziomice
pożądny klijęt - porządny klient
póbliczności - publiczności
pódełko - pudełko
pół okrongłe - półokragłe
półałtomatycznie - półautomatycznie
pnełmatyczna - pneumatyczna
prenta - pręta
pretęsja - pretensja
prezęt  - prezent
prezętują - prezentują
prętkość - prędkość
procentah - procentach
prondo tfórczy - prądotwórczy
protokuł - protokół
prozkach - prążkach
proźbę - prośbę
prubki - próbki
prucz - prócz
przczulka - pszczółka
przeczkola - przedszkola
przejaszczka - przejażdżka
przegrudka  - przegródka
przegrutkami - przegródkami
przekomażać - przekomarzać
przekur - przekór
przelodkami - przelotkami
przełańczasz - przełączasz
przemiekiej - przemiękkiej
przepiegla - przebiegła
przerurznyh - przeróżnych
przes - przez
przeszczekam - przestrzegam
przeziembiamy - przeziębiamy
przeżudki - przerzutki
przeżutkę - przerzutkę
przyszybsza - przyśpiesza
przyżec - przyrzec
pseldo - pseudo
psełdonimu - pseudomimu
pszecież - przecież
pszedmiotem - przedmiotem
pszedwzmacniacz - przedwzmacniacz
pszepraszam - przepraszam
pszesyłce - przesyłce
pszeszycia - przeszycia
pszędzona - przędziona
pszężyto - pszenżyto
pszkami - paszkami
pszud - przód
pszut, pszody - przód, przody
pszustawka - przystawka
pszychicznej - psychicznej
pszycisku - przycisku
pszygodówka - przygodówka
pszyssawek - przyssawek
puhar - puchar
pujść - pójść
pulka - półka
pułautomat - półautomat
puźniej - później
pżegżać - przegrzać
pżydatny - przydatny
qwarcowy  - kwarcowy
rąby - romby
rególowany - regulowany
renczny - ręczny
renkawa - rekawa
renke - rękę
renkojmia - rękojmia
rękompensuje - rekompensuje 
rgnalna - oryginalna
rodzaji - rodzajów
roguw - rogów
rolnetka - lornetka
rołter - router
roskoszy - rozkoszy
roszczarowany - rozczarowany
rośćęciami - rozcięciami
rozcieńciami - rozcięciami
rozpakuwającego - rozpakowującego
rozrosznik  - rozrusznik
róbin - rubin
ródych - rudych
róra - rura
rórze - rurze
rórznych - różnych
rurznego - różnego
ruwniesz - również
ruzne  - różne
ruże - róże
rysze - rysuje
rzaden - żaden
rzale - żale
rzeby - żeby
rzelaska - żelazka
rzelaza - żelaza
rzyczenia - życzenia
ómawialiśmy sie - umawialiśmy się
sady - sondy
samobierzny - samobieżny
samochud - samochód
sandłycz - sandwich
sąnczony - skończony
seif - sejf
seksowana - seksowna(?)
separacjacja  - separacja
serwisą - serwisom
sexsowny - seksowny
sfastyka - swastyka
sfeter  - sweter
sfetr - swetr
sfond - swąd
siwiece - świece
skaji - skaju
skataktowal - skontaktował
sklepą - sklepom
skłat - skład
skompy - skąpy
skozany  - patrz: skużany
skótek - skutek
skreny - screeny
skrucie  - skrócie
skura  - skóra
skużany  - skórzany
słociutka - słodziutka
słóżbówke - służbówkę
słóżyć - służyć
smarzenia - smażenia
soł - są
som - są
sóper - super
sówak  - suwak
sposub - sposób
spowrotem  - z powrotem
spójście - spójrzcie
spószczania - spuszczania
sprawć - sprawdź
spręrzyny - sprężyny
sprzencie - sprzęcie
sprzent - patrz: sprzęd
sprzęd - sprzęt
sprzodu - z przodu
spudnica  - spódnica
spudnica z sówakiem - patrz: spudnica, sówak
spudnisia - spódnisia
spujrz - spójrz
spułpracuje - współpracuje
spusub - sposób
starorzytny - starożytny
starz - staż
stęplami - stemplami
strące - stronce
strąg - strąk
strąg - strong
struj - strój
stujką - stójką
stupkę - stópkę
stwaza - stwarza
stymże - patrz: ztymze
sufmiarka - suwmiarka
swienty - świetny
sylikon  - silikon
szawce - szafce
szczela - strzela
szczeże - szczerze
szef ozdobny - szew ozdobny
szie - się
szfankuje - szwankuje
szkatółka - szkatułka
szkodzka - szkocka
szkopół - szkopuł
szkrzypce - skrzypce
szlówki  - szlufki
sznoreczek - sznureczek
sztrzela - strzela
szybciotko - szybciutko
szybciudko - szybciutko
szybko łudź motorowo - szybką łódź motorową
szyiki - szyjki
szypkości - szybkości
szwónkiel - patrz: funkiel
ścianom - ścianą
śćęty - ścięty
śiwtenia - świetnie
ślifierka - szlifierka
ślifowania - szlifowania
śnierzno-bialy - śnieżno-biały
Śnieszka - Śnieżka
śróbki - śrubki
tagrze  - także
tagże  - także
tak że - także
takrze  - także
tależ  - talerz
tamicerka skurfopodobna - tapicerka skóropodobna
tatułazy - tatuaży
tawty - tafty
tąbak - tombak
tchurzo-fretka - tchórzofretka
tempy - tępy
tempy urzytkownik - patrz: tempy, urzytkownik
terkocenia - terkotania
terz  - patrz: tesz
tesz  - też
tęperatura - temperatura
tępo za wolne - tempo za wolne
tłómik  - tłumik
tomachawek - tomahawek
topur - topór
torepki - torebki
tóż - tuż
transwer - transfer
tranzakcja  - transakcja
trendowatego - trędowatego
trędów - trendów
tródno - trudno
trujkonty - trójkąty
trzcionka  - czcionka
tupka - tubka
twartsze - twradsze
tważ - twarz
tylnia - tylna
tymbaku - tombaku
tżeba - trzeba
udziane - udziergane
uhwyty - uchwyty
uleprzenia - ulepszenia
umie - u mnie
umię - umiem
uprzarz - patrz: uprząsz
uprząsz - patrz: upsząsz
upsząsz - uprząż
urzytkownik  - użytkownik
urzytku  - użytku
urzywany  - używany
uszczerbaną - wyszczerbioną
utrzciwość - uczciwość
uwczesnym - ówczesnym
uwież - uwierz
uzadzonko - urządzonko
uzytkownią - użytkownikom
uzydkowaniu - użytkowaniu
w cale - wcale
w krutce - wkrótce
w rewanży - w rewanżu
w zdloz - wzdłuż
wachac  - wahać
wachac  - wąchać
warmazoniaż - farmazoniarz
waszka - ważka
wcionga - wciąga
wedłóg - według
wejć - wejdź
wekęt - weekend
weler - feler
welór - welur
welury - weluru
wendka - wędka
weterynaż - weterynarz
wętylatorek - wentylatorek
wiatruwka - wiatrówka
wienc - więc
wierza  - wieża
wiekrzoości - większości
4 kg wiur - wiórów
wizułalny - wizualny
wkórzył - wkurzył
wlancza  - włącza
wogule  - w ogóle
wontpliwości - wątpliwości
wougle - w ogóle
wólgaryzmy - wulgaryzmy
wpalpnych - wypalonych
wpłynoł  - wpłynął
wpożątku - w porządku
wrazie - w razie
wreście - wreszcie
wręć - wręcz
wrządkiem - wrzątkiem
wsac - wsadź
wsczol - wszczął
wsgkedu - względu
wsówki - wsuwki
wspulczesnym - współczesnym
wszczymac - wstrzymać
wuwczas - wówczas
wyblaknięty - wyblakły
wybur - wybór
wychawtowany - wyhaftowany
wyciąkcie - wyciągnijcie
wygarnywania - wygarniania
wyglonda - wygląda
wyłoncznik - wyłącznik
wyniknęła - wynikła
wyprówać - wypruwać
wyrzej - wyżej
wysciułki - wysciółki
wyslyki - wysyłki
wysoka koturna - wysoki koturn
wysprzedasz - wyprzedaż
wyśleże - myślę, że
wziąść - wziąć
wzorzaste - wzorzyste
wzroki - spojrzenia, hyhy
yensach - dżinsach
z owąt - zowąd
z żędu - z rzędu
za bespieczyc - zabezpieczyć
zabydkowych - zabytkowych
zaczask - zatrzask
zaczoł - zaczął
zadko  - patrz: żadko
zadkosc  - rzadkość
zagatka - zagadka
zaginięte - zaginione
zaguwki - zagłówki
zajżyj - zajrzyj
zakączona - zakończona
zakontków - zakątków
zakupiany - zakupiony
zakużony - zakurzony
zalerzy  - zależy
zamatowane - zamontowane
zamątowałem - zamontowałem
zament - zamęt
zapażacz - zaparzacz
zaporzyczone - zapożyczone
zapuzno - za późno
zaruwno - zarówno
zarzycia - zażycia
zaszczerzen - zastrzeżeń
zaśieńk - zasięg
zażutów  - zarzutów
zabląbowany - zaplombowany
zasięk  - zasięg
zbierzność - zbieżność
zbiur - zbiór
zczymsz - z czymś
zdeżak  - zderzak
zdiedcie - zdjęcie
zdjencia - zdjęcia
zelasko - żelazko
zestaf  - zestaw
zezbiony  - rzeźbiony
zgury - z góry
zielonej guze - Zielonej Górze
zjęcie - zdjęcie
zkoro - skoro
zlikfidowanego - zlikwidowanego
złuzyte - zużyte
znalesc - znaleźć
znapendem - z napędem
zniszka - zniżka
zparszam - zapraszam
ztymze - z tym, że
zurzycie - zużycie
zwerza - zwęża
zwięczająca - zwieńczająca
zylandor - żyrandol
źrudło - źródło
żadko - patrz: żatko
żandariera - żardyniera
żatko - rzadko
żąkili - żonkili
żeczy - rzeczy
żeczywistość  - rzeczywistość
żemyk - rzemyk
żepem - rzepem
żetelny - rzetelny
żeźba - rzeźba
żucać - rzucać
żułty - żółty
żutuje - rzutuje